 wwwwwwww           wwwwwwwww 
w        ww       ww         w
w          ww   ww           w
w            w w             w
w             w              w
 w               m m    o   w 
  w            swwwwwwwwww w  
    w          s          w   
     w         s         w    
      w  i     s  l     w     
       w wwwwwwswwww   w      
        w      s      w       
         w     s     w        
          w    s    w         
           w   s   w          
            w  s  w           
             w   w            
              wkw             
               w              
