wwwwwwwwwwwwwwwwwwwww
w                   w
w                   w
w   w         w     w
w  w wwwwwwwww w    w
w  w           w    w
w  w w   k   w w    w
w   wm       mw     w
w    wwwwswwww      w
w        s          w
w        s          w
w        s          w
w i      s         ow
wwwwwwwwwwwwwwwwwwwww
