wwwwwwwwwwwwwwwwwwwwwwwwwwwwwwwwww
w                               ow
w                         swwwwwww
w         m               sw1 ll w
w        ww               swwwww w
w    m ww  ww             sw     w
w    ww      w            sw     w
w             w       m   ww     w
w  ww          wwwwswwwwww       w
w                  s             w
wk   ww            s             w
www     wwwwwwwwwwwsw          s w
w   ww  w          s         wws w
w       w1     m   s      ww   s w
www     wwwwwwwwwwwwwwwww      s w
w  w    w                      s w
wm     m      m www      m     s w
wwwwwwwwwwwwwwwwwwwwwwwwwwwwwwwsww
                            w  s w
                            w  s w
                   wwwwwwwwww  s w
                   w i         s w
                   wwwwwwwwwwwwwww
