wwwwwwwwwwwwwwwwwwwwwwwwwwwwwwwwwwwwwwwww
w                                       w
w1      m           m            m     sw
wwww  wwwwwwwww  wwwwwwww www wwwwwwwwwsw
w                             w2  ow   sw
w                  m          wwwwww   sw
w                 wwwww                sw
w           w    w                     sw
w     w    w    w      ww              sw
w    w   kw  wwww                      sw
w   w   ww                www          sw
w  w                                   sw
wiww                         w    m    sw
ww                             wwwwwwwwww
                               w        w
                               w2      1w
                               wwwww  www
wwwwwwwwwwwwwwwwwwwwwwwwwwwwwwww     w  w
w                                   w   w
w                                  w    w
w                                 w     w
wk     m       m       m  m      w      w
wwwwwwwwwwwwwwwwwwwwwwwwwwwwwwwwwwwwwwwww
