wwwwwwwwwwwwwwwwwwwwwwwwwwwwwwwwwwwww
w                                  ow
w             wwwww             swwww
w             w  kw             s   w
w             wwsww             s   w
w               s               ss  w
w               s                s  w
w               s                s  w
w               s                s  w
w i      k      s                s  w
wwwwwwwwwwwwwwwwwwwwwwwwwwwwwwwwwwwww
